50 50
0 0 0 0 0 0 0 0 0 0 0 0 0 0 0 0 0 0 0 0 0 0 0 0 0 0 0 0 0 0 0 0 0 0 0 0 0 0 0 0 0 0 0 0 0 0 0 0 0 0 
0 0 0 0 0 0 0 0 0 0 0 0 0 0 0 0 0 0 0 0 0 0 0 0 0 0 0 0 0 0 0 0 0 0 0 0 0 0 0 0 0 0 0 0 0 0 0 0 0 0 
0 0 0 0 0 0 0 0 0 0 0 0 0 0 0 0 0 0 0 0 0 0 0 0 0 0 0 0 0 0 0 0 0 0 0 0 0 0 0 0 0 0 0 0 0 0 0 0 0 0 
0 0 0 0 0 0 0 0 0 0 0 0 0 0 0 0 0 0 48 49 0 0 0 0 0 0 0 0 0 0 0 0 0 0 0 0 0 0 0 0 0 0 0 0 0 0 0 0 0 0 
0 0 0 0 0 0 0 0 0 0 0 0 0 0 0 0 0 0 54 55 0 0 0 0 0 0 0 0 0 0 0 0 0 0 0 0 0 0 0 0 0 0 0 0 0 0 0 0 0 0 
16 16 16 16 16 16 16 16 16 16 16 16 4 0 0 0 0 0 60 61 3 16 16 16 16 16 16 16 16 16 16 16 16 16 16 16 16 16 16 16 16 16 20 0 0 0 0 50 0 0 
9 9 9 9 9 9 9 9 8 9 9 9 11 0 0 0 0 0 66 67 10 9 9 9 9 9 2 9 9 9 9 9 9 9 9 9 9 9 9 9 9 9 11 0 0 0 0 0 0 0 
23 23 23 23 23 23 23 23 23 23 23 24 18 16 16 16 16 16 16 16 17 9 9 9 9 9 9 9 9 9 9 9 1 9 9 9 9 9 9 9 9 8 11 0 33 35 0 0 0 0 
0 0 0 0 0 0 0 0 0 0 0 12 23 23 23 23 23 23 23 23 24 9 9 9 9 1 9 9 9 9 9 9 9 9 9 9 9 9 9 9 9 9 11 0 0 0 0 0 0 0 
0 0 0 0 0 0 0 0 0 0 0 0 0 0 0 0 0 0 0 0 31 23 23 23 23 23 23 23 23 23 23 23 23 23 23 23 23 23 23 23 23 23 27 48 49 0 0 33 35 0 
62 0 0 0 0 0 0 0 0 48 49 0 0 0 0 0 0 0 0 0 0 0 0 0 0 0 0 0 0 0 0 0 0 0 0 0 0 0 0 0 0 0 0 54 55 0 0 0 0 0 
68 0 0 0 0 0 0 0 0 54 55 0 0 0 0 0 0 0 0 0 0 0 0 0 0 0 0 0 0 0 0 0 0 0 0 0 0 0 0 0 0 0 0 60 61 0 0 0 0 0 
19 19 19 20 0 0 0 0 0 60 61 0 0 0 0 0 0 0 0 0 0 0 0 0 0 0 0 0 0 0 0 50 0 0 0 0 0 0 0 0 0 0 0 66 67 0 0 0 0 0 
9 9 9 11 0 0 0 0 0 66 67 0 3 16 16 16 16 16 16 16 16 16 4 0 0 0 0 0 0 0 0 0 0 3 16 16 16 16 16 16 16 16 16 16 16 16 16 16 16 19 
9 2 9 11 7 0 0 0 3 19 19 19 17 2 9 9 9 9 9 9 9 9 18 16 16 16 16 16 16 16 16 16 16 17 9 9 9 9 9 9 9 9 9 9 9 9 9 9 9 9 
9 9 9 11 0 0 0 0 10 9 9 9 9 9 9 9 9 9 9 9 9 9 9 9 9 9 9 9 9 9 9 9 9 9 9 9 9 1 9 9 9 9 9 9 9 9 9 9 9 9 
2 9 26 27 0 0 0 0 10 9 9 9 9 9 9 9 9 9 9 9 9 1 9 9 9 9 9 9 9 9 9 9 1 9 9 9 9 9 9 9 9 9 9 9 9 9 9 9 9 9 
31 32 0 0 0 0 30 0 10 9 9 9 9 9 1 9 9 9 9 9 9 9 9 9 9 9 9 2 9 9 9 9 9 9 9 9 9 25 26 26 26 26 26 26 26 26 26 26 26 26 
0 0 0 0 0 0 0 0 10 9 9 9 9 9 9 9 9 9 9 9 9 9 9 9 9 9 9 9 9 9 9 9 9 9 9 25 26 27 0 0 0 0 0 0 0 0 0 0 0 0 
0 0 0 0 0 0 0 0 31 23 23 23 23 23 23 23 23 23 23 23 24 9 9 9 9 9 25 26 26 26 26 26 26 26 26 27 0 0 0 0 0 0 0 0 0 0 0 0 0 0 
0 0 0 0 29 0 0 0 0 0 0 0 0 0 0 0 0 0 0 0 31 23 23 23 23 23 27 0 0 0 0 0 0 0 0 0 0 0 0 0 0 0 0 0 0 0 0 0 0 0 
0 0 62 0 0 0 0 0 0 0 50 0 0 0 0 0 0 0 0 0 0 0 0 0 0 0 0 0 0 0 0 0 0 0 0 0 0 0 0 0 0 0 0 0 0 0 0 0 0 62 
16 4 68 0 0 0 0 0 0 0 0 0 0 0 0 0 0 0 0 0 0 0 0 0 0 0 0 0 0 0 0 0 0 0 0 0 0 0 0 0 0 0 0 0 0 0 0 0 0 68 
9 18 19 16 16 16 16 16 4 0 0 0 0 0 0 0 0 0 0 0 0 0 0 0 15 16 16 16 16 16 16 16 16 20 0 33 34 35 0 0 0 3 16 16 16 16 16 16 16 16 
9 9 9 8 9 9 9 9 18 4 0 0 0 0 0 0 0 0 0 0 78 79 0 15 17 9 9 9 9 9 9 9 9 11 0 0 0 0 0 0 0 10 9 9 9 9 9 9 9 9 
9 9 9 9 9 1 9 9 9 9 16 16 16 16 16 16 16 16 16 16 16 16 16 17 9 9 9 9 9 9 9 1 9 11 0 0 0 0 0 0 15 17 9 2 9 9 9 9 9 9 
9 1 9 9 9 9 9 9 9 9 9 9 9 9 9 9 9 9 9 9 9 9 9 9 9 9 9 9 1 9 9 9 9 11 0 0 0 29 3 16 17 9 9 9 9 9 9 9 9 9 
9 9 9 9 9 9 9 9 9 9 9 9 9 9 9 9 9 9 9 9 9 8 9 9 9 9 9 9 9 9 9 9 9 11 0 0 0 0 10 9 9 9 9 9 9 9 9 9 9 9 
9 9 9 9 9 1 9 9 9 9 9 9 9 9 1 9 9 25 26 26 26 26 26 26 26 26 26 24 9 9 9 9 9 11 29 0 0 0 10 9 9 9 9 9 9 9 9 2 9 9 
23 24 9 9 9 9 9 9 9 9 9 9 9 9 9 9 9 11 0 0 0 0 0 0 0 0 0 22 23 23 23 23 23 32 0 0 0 29 22 23 23 23 23 23 23 23 23 23 23 23 
0 22 26 26 26 26 26 26 26 26 26 26 26 26 26 26 26 27 0 0 0 0 0 0 0 0 0 0 0 0 0 0 0 0 0 0 0 0 0 0 0 0 0 0 0 0 0 0 0 0 
0 0 0 0 0 0 0 0 0 0 0 0 0 0 0 0 0 0 0 0 0 0 0 48 49 0 0 0 0 0 0 0 0 0 0 29 0 0 0 0 0 0 0 0 0 50 0 0 0 0 
0 0 0 0 0 0 0 0 0 0 0 0 0 0 0 0 0 0 0 0 0 0 0 54 55 0 0 0 0 0 0 0 0 0 0 0 0 0 0 0 0 0 0 0 0 0 0 0 0 0 
0 0 0 0 0 0 0 0 0 0 0 0 0 0 0 0 0 0 0 0 0 0 0 60 61 0 0 0 0 0 0 0 0 0 0 0 0 0 0 0 0 3 16 16 16 16 16 16 16 16 
0 0 0 0 0 0 0 0 0 0 0 80 81 0 0 0 0 0 0 0 0 0 0 66 67 3 16 16 16 16 16 16 16 16 16 16 16 16 16 16 16 17 9 9 2 9 9 9 9 9 
0 0 0 0 0 0 33 34 34 34 34 34 34 35 0 0 0 0 69 70 3 16 16 16 16 17 9 9 9 9 9 1 9 9 9 9 9 9 9 9 9 9 9 9 9 9 9 9 1 9 
0 0 0 0 0 0 0 0 0 0 0 0 0 0 0 0 0 0 75 76 10 9 9 9 9 9 1 9 9 9 9 9 9 9 9 9 9 9 9 9 1 9 9 9 9 9 9 9 9 9 
16 16 4 0 0 0 0 0 0 0 0 0 0 0 0 0 0 0 0 3 1 9 9 9 9 9 9 2 9 9 9 9 9 9 9 9 9 9 9 9 9 9 9 9 9 9 1 9 9 9 
9 9 2 4 0 0 0 0 0 0 0 0 0 0 0 0 0 0 0 10 1 9 9 1 9 9 9 9 1 25 23 23 23 23 23 23 23 23 23 23 23 23 23 23 23 24 9 9 9 9 
1 9 9 9 4 0 0 0 48 49 0 0 0 0 0 0 0 0 0 22 24 25 23 23 23 23 23 23 23 27 0 0 0 0 0 0 0 0 0 0 0 0 0 0 0 31 23 23 23 23 
9 9 9 9 9 4 0 0 54 55 0 0 0 0 0 0 0 0 29 0 31 32 0 0 0 0 0 0 0 0 0 0 0 0 0 0 0 0 0 0 0 0 0 0 0 0 0 0 0 0 
9 9 9 9 9 9 4 0 60 61 0 0 0 0 0 0 0 0 0 0 0 0 0 0 0 0 0 0 0 0 0 0 0 0 0 0 0 0 0 0 0 0 0 0 0 0 0 0 0 0 
9 1 9 9 1 9 11 0 66 67 0 0 0 0 0 0 0 82 83 0 0 0 0 0 0 0 0 0 0 0 0 0 0 0 0 0 0 0 50 0 0 0 0 0 0 0 0 0 0 0 
9 9 9 9 9 9 18 16 16 16 16 16 16 16 16 16 16 16 16 4 0 0 0 0 0 0 0 0 0 0 0 0 0 0 0 0 0 0 0 0 0 0 0 0 0 0 0 0 0 0 
9 9 9 9 9 9 9 9 9 9 9 9 9 9 9 9 9 8 9 18 4 0 0 0 0 0 0 0 0 0 0 0 0 0 0 0 0 0 0 0 0 0 0 0 0 0 0 0 0 0 
9 9 9 8 9 9 9 9 9 9 9 9 9 1 9 9 9 9 9 9 2 4 0 0 0 0 0 0 0 0 0 0 0 0 0 0 0 0 0 0 0 0 0 0 0 3 16 16 16 16 
9 9 9 9 9 9 1 9 9 9 9 2 9 9 9 9 9 9 9 9 9 11 0 0 0 0 0 0 0 0 0 0 0 0 0 0 0 0 0 0 0 0 0 0 0 10 9 2 9 9 
9 9 9 1 9 9 9 9 9 9 9 9 9 9 9 9 9 9 9 9 9 18 16 16 16 16 16 16 16 16 16 16 16 16 16 16 16 16 16 16 16 16 16 16 16 17 9 9 9 9 
9 1 9 9 9 9 9 1 9 9 9 9 9 9 9 9 9 9 9 9 9 9 9 9 9 9 9 9 8 9 9 9 9 9 9 9 9 9 9 9 9 2 9 9 9 9 9 9 9 9 
9 9 9 9 9 9 9 9 9 9 9 9 9 9 9 1 9 9 9 9 9 9 9 9 9 9 9 9 9 9 9 1 9 9 9 9 9 1 9 9 9 9 9 9 9 9 9 1 9 9
16 64
6
0 416 768 32
768 448 385 32
1152 480 576 64
1727 543 352 32
2080 511 384 32
2464 544 1377 32
10
448 384 1
544 384 2
864 416 2
1024 416 2
1280 448 2
1408 448 1
1536 448 2
1824 512 1
1952 512 2
2272 480 1
8
228 384
736 416
1120 448
1472 800
1696 448
1696 512
2080 512
2432 512
1
1888 512
3808 191 32 355